Name,ExpToNextLevel,SummonerLevel,TowerLevel,TroopLevel,Decks,SummonerKillGold,TowerKillGold,DiamondReward
String,int,int,int,int,int,int,int,int
1,20,1,1,1,1,0,0,
2,50,2,2,2,1,0,0,
3,100,3,3,3,1,0,0,
4,200,4,4,4,1,0,0,
5,400,5,5,5,1,0,0,
6,600,6,6,6,1,0,0,
7,800,7,7,7,1,0,0,
8,1000,8,8,8,1,0,0,
9,3000,9,9,9,1,0,0,
10,5000,10,10,10,1,0,0,
11,6000,11,11,11,1,0,0,
12,7000,12,12,12,1,0,0,
13,38800,13,13,13,1,0,0,
